way down deep - глубоко в душе
zap-wing - летучая мышь
scooch over - подвинься
swoop in out of nowhere - налетели из ниоткуда
stow - укладывать - Stow those casks (бочки) forward.
chowder - похлепка
deplorable - прискорбно
turn a corner - наладиться
apprehend - задерживать
probation - испытательный срок
interject - вставить
back off - отвали
statute - устав
impound - конфисковать
slip-ups - промахи
felon - преступник 
preposterous - нелепый
comission - заказ - I'll comission a ship.
We hear some sence
make it up to you - загладить свою вину
There we are then - ну вот и все.
We will be off - мы отправляемся
familiarity breeds contempt - чем ближе знаешь, тем меньше любищь
contempt - неуважение
second berth on your right - второй причал справа от вас
fluster - нервничать - I get so flustered.
heave - поднимать - Heave together now.
mean - намереваться
aloft - The captain is aloft.
stop on - безошибочный
flatter - льстить
presume - предполагать
sterling - надежный
dependable - заслуживающий доверия
I don't mean a word of it. - На самом деле я так не думаю.
banter - подшучивать
blabber - болтовня
muse - размышлять
ineptitude - It demonstates a level of ineptitude that borders on the imbecilic(слабоумие).
I mean that in very caring way.
That will do. - Хорошо!
ludicrous parcel - нелепая посылка
whole shebang - весь расклад
neophyte - новичек
galley - камбуз
got me - заставил меня - She is got me thinking.
tuck - заправлять - I had have tucked in me shirt.
put off by - растраиваться
These gears have been tough getting used to. - К этим механизмам было сложно привыкнуть
mighty handy - очень удобно
tangy - острый
robust - крепкий
swig - глоток - have a swig
blob of mischief - капля озорства
We are about to get underway - Мы вот-вот начнем
see to it - позаботься - See to it the new cabin boy's kept busy.
slew - множество - There is slew of cyborgs roaming this port.
cast off - отправка
scurvy - цинга 
scum - подонок
brace yourself - подготовится, собраться
upon my word - честное слово
I'd stand clear - Я бы встал подальше
floozy - шлюха
impudent - наглый
brawling - драка - There will be no brawling on this ship.
confine - заточать - Any further offenders will be confined to the brig (заключены в тюрьму).
Belay that. - Отставитью.
swab - швабра 
mutiny - мятеж
run him ragged - загрузить работой
He was more the taking off and never coming back sort.
chart - составлять
helm - вести, руководить, руль, штурвал
no matter the squalls - несмотря на шквалы
cozied up - сблизился, вошел в доверие - I cozied up to that kid to keep him off our scent.
makings - задатки - You got the makings.
cut of your jib - твое упорство
I best be getting some shut-eye. - Я лучше посплю.
knock it off - брось
We were sick of all this waiting. - Мы устали от всего этого ожидания.
I know otherwise. - Я знаю другое.
Methinks - Мне кажется.
whelp - щенок
cutthroat - головорез
fiendish - дьявольский
constabulary - полиция
baffle me - сбивают с толку
fuzzy - нечеткий
palaver - болтовня
pestilent - ядовитый
I will take it from here. - Я сам.
I was at the end of my rope. - Я был на грани.
ever since - с тех пор
Treasure is only boat ride away. - Сокровища в нескольких минутах езды на лодке.
I didn't mean - Я не хотел.
aloft - наверху
from stem to stem - от носа до кормы
shipshape - в полном порядке
run-in - схватка
It demonstrates a level of ineptitude (глупость) that borders on the imbecilic (слабоумие).
galoot - неуклюжий человек
cut me off - отшил
shroud - покров, колпак
aberration - отклонение
He should learn to mind their own business. - Должен научиться заниматься своими делами.
finagle - надувать
upstanding crew - достояная команда
daft - глупый
Take us out of here. - Вывези нас отсюда.
claptrap - болтовня
thrusters - двигатели